7 10
----------
0000000000
0----0----
0----0----
-0--0-----
--00------
---0------